//MAP CONVERTED BY dmm2tgm.py THIS HEADER COMMENT PREVENTS RECONVERSION, DO NOT REMOVE
"a" = (
/turf/open/space/basic,
/area/space)
"b" = (
/turf/closed/wall/vampwall/wood,
/area/vtm/forest)
"c" = (
/obj/item/flashlight/lantern{
	on = 14;
	light_on = 1
	},
/turf/open/floor/plating/rough,
/area/vtm/forest)
"d" = (
/obj/structure/curtain/bounty,
/turf/closed/wall/vampwall/wood/low,
/area/vtm/forest)
"e" = (
/turf/open/floor/plating/vampgrass/random/grass,
/area/vtm/forest)
"f" = (
/obj/transfer_point_vamp{
	id = "caern_entrance"
	},
/turf/open/floor/plating/vampdirt,
/area/vtm/forest)
"g" = (
/turf/open/floor/plating/vampdirt,
/area/vtm/forest)
"h" = (
/obj/structure/werewolf_totem/generic,
/turf/closed/wall/vampwall/wood/low,
/area/vtm/forest)
"i" = (
/obj/item/flashlight/lantern{
	on = 14;
	light_on = 1
	},
/turf/open/floor/plating/vampgrass/random/grass,
/area/vtm/forest)
"j" = (
/turf/closed/wall/vampwall/rock,
/area/vtm/forest)
"k" = (
/obj/structure/glowshroom,
/turf/open/floor/plating/rough/cave,
/area/vtm/forest)
"l" = (
/turf/open/floor/plating/vampcrossableocean,
/area/vtm/forest)
"m" = (
/turf/open/floor/plating/vampplating/stairs/black{
	dir = 4
	},
/area/vtm/forest)
"n" = (
/obj/structure/chair/wood,
/turf/open/floor/plating/rough/cave,
/area/vtm/forest)
"o" = (
/obj/structure/closet/cabinet,
/turf/open/floor/plating/rough/cave,
/area/vtm/forest)
"p" = (
/turf/closed/wall/vampwall/wood/low,
/area/vtm/forest)
"q" = (
/obj/effect/turf_decal/siding/wood{
	dir = 10
	},
/turf/open/floor/plating/parquetry/old,
/area/vtm/forest)
"s" = (
/turf/open/space/basic,
/area/vtm/planetgeneration)
"t" = (
/obj/structure/glowshroom,
/turf/open/floor/plating/rough,
/area/vtm/forest)
"u" = (
/obj/structure/table/wood,
/turf/open/floor/plating/rough/cave,
/area/vtm/forest)
"v" = (
/obj/structure/glowshroom/glowcap,
/turf/open/floor/plating/rough/cave,
/area/vtm/forest)
"w" = (
/obj/effect/turf_decal/siding/wood/end{
	color = "#4a3925";
	dir = 4
	},
/obj/effect/turf_decal/siding/wood/end{
	color = "#4a3925";
	dir = 8
	},
/obj/effect/decal/pallet{
	pixel_y = 4;
	pixel_x = 1
	},
/turf/open/floor/plating/vampdirt,
/area/vtm/forest)
"x" = (
/turf/open/floor/plating/rough,
/area/vtm/forest)
"y" = (
/turf/open/floor/plating/vampplating/stairs/black{
	dir = 1
	},
/area/vtm/forest)
"A" = (
/obj/effect/turf_decal/siding/wood/end{
	color = "#4a3925";
	dir = 4
	},
/obj/effect/turf_decal/siding/wood/end{
	color = "#4a3925";
	dir = 8
	},
/obj/effect/decal/pallet{
	pixel_y = 4;
	pixel_x = 1
	},
/turf/open/floor/plating/vampcrossableocean,
/area/vtm/forest)
"B" = (
/obj/item/flashlight/lantern{
	on = 14;
	light_on = 1
	},
/turf/closed/wall/vampwall/wood/low,
/area/vtm/forest)
"C" = (
/obj/effect/turf_decal/siding/wood,
/turf/open/floor/plating/parquetry/old,
/area/vtm/forest)
"D" = (
/obj/effect/turf_decal/siding/wood{
	dir = 4
	},
/turf/open/floor/plating/parquetry/old,
/area/vtm/forest)
"E" = (
/obj/structure/bed,
/turf/open/floor/plating/rough/cave,
/area/vtm/forest)
"F" = (
/obj/effect/decal/support,
/turf/open/floor/plating/rough/cave,
/area/vtm/forest)
"G" = (
/turf/open/floor/plating/rough/cave,
/area/vtm/forest)
"H" = (
/obj/structure/curtain/bounty,
/turf/open/floor/plating/rough/cave,
/area/vtm/forest)
"I" = (
/turf/open/space/basic,
/area/vtm/forest)
"K" = (
/turf/open/floor/plating/vampocean,
/area/vtm/forest)
"L" = (
/obj/effect/decal/shadow,
/turf/open/floor/plating/rough,
/area/vtm/forest)
"M" = (
/obj/structure/table/wood,
/turf/open/floor/plating/rough,
/area/vtm/forest)
"N" = (
/obj/structure/werewolf_totem/generic,
/turf/open/floor/plating/parquetry/old,
/area/vtm/forest)
"P" = (
/obj/item/flashlight/lantern{
	on = 14;
	light_on = 1
	},
/turf/open/floor/plating/vampdirt,
/area/vtm/forest)
"Q" = (
/obj/effect/turf_decal/siding/wood{
	dir = 6
	},
/turf/open/floor/plating/parquetry/old,
/area/vtm/forest)
"R" = (
/obj/effect/decal/support,
/turf/open/floor/plating/rough,
/area/vtm/forest)
"S" = (
/turf/open/floor/plating/vampplating/stairs/black{
	dir = 8
	},
/area/vtm/forest)
"T" = (
/obj/structure/dresser,
/obj/item/flashlight/lantern{
	on = 14;
	light_on = 1;
	pixel_y = 9
	},
/turf/open/floor/plating/rough/cave,
/area/vtm/forest)
"U" = (
/turf/open/floor/plating/vampdirt,
/area/vtm/planetgeneration)
"V" = (
/obj/effect/turf_decal/siding/wood{
	dir = 8
	},
/turf/open/floor/plating/parquetry/old,
/area/vtm/forest)
"W" = (
/obj/structure/bonfire/dense,
/turf/open/floor/plating/vampdirt,
/area/vtm/forest)
"X" = (
/obj/structure/glowshroom/glowcap,
/turf/open/floor/plating/rough,
/area/vtm/forest)
"Y" = (
/obj/item/flashlight/lantern{
	on = 14;
	light_on = 1
	},
/turf/open/floor/plating/rough/cave,
/area/vtm/forest)
"Z" = (
/turf/open/floor/plating/vampgrass/random/grass,
/area/vtm/planetgeneration)

(1,1,1) = {"
a
a
a
a
a
a
a
a
a
a
a
a
a
a
a
a
a
a
a
a
a
a
a
a
a
a
a
a
a
a
a
a
a
a
a
a
a
a
a
a
a
a
a
a
a
a
a
a
a
a
a
a
a
a
a
a
a
a
a
a
a
a
a
a
a
a
a
a
a
a
a
a
a
a
a
a
a
a
a
a
a
a
a
a
a
a
a
a
a
a
a
a
a
a
a
a
j
j
j
j
"}
(2,1,1) = {"
a
a
a
a
a
a
a
a
a
a
a
a
a
a
a
a
a
a
a
a
a
a
a
a
a
a
a
a
a
a
a
a
a
a
a
a
a
a
a
a
a
a
a
a
a
a
a
a
a
a
a
a
a
a
a
a
a
a
a
a
a
a
a
a
a
a
a
a
a
a
a
a
a
a
a
a
a
a
a
a
a
a
a
a
a
a
a
a
a
a
a
a
a
a
a
j
j
K
K
j
"}
(3,1,1) = {"
a
a
a
a
a
a
a
a
a
a
a
a
a
a
a
a
a
a
a
a
a
a
a
a
a
a
a
a
a
a
a
a
a
a
a
a
a
a
a
a
a
a
a
a
a
a
a
a
a
a
a
a
a
a
a
a
a
a
a
a
a
a
a
a
a
a
a
a
a
a
a
a
a
a
a
a
a
a
a
a
a
a
a
a
a
a
a
a
a
a
a
a
a
a
j
j
K
K
K
j
"}
(4,1,1) = {"
a
a
a
a
a
a
a
a
a
a
a
a
a
a
a
a
a
a
a
a
a
a
a
a
a
a
a
a
a
a
a
a
a
a
a
a
a
a
a
a
a
a
a
a
a
a
a
a
a
a
a
a
a
a
a
a
a
a
a
a
a
a
a
a
a
a
a
a
a
a
a
a
a
a
a
a
a
a
a
a
a
a
a
a
a
a
a
a
a
a
a
a
a
j
j
K
K
K
K
j
"}
(5,1,1) = {"
a
a
a
a
a
a
a
a
a
a
a
a
a
a
a
a
a
a
a
a
a
a
a
a
a
a
a
a
a
a
a
a
a
a
a
a
a
a
a
a
a
a
a
a
a
a
a
a
a
a
a
a
a
a
a
a
a
a
a
a
a
a
a
a
a
a
a
a
a
a
a
a
a
a
a
a
a
a
a
a
a
a
a
a
a
a
j
j
j
j
a
a
j
j
K
K
K
K
K
j
"}
(6,1,1) = {"
a
a
a
a
a
a
a
a
a
a
a
a
a
a
a
a
a
a
a
a
a
a
a
a
a
a
a
a
a
a
a
a
a
a
a
a
a
a
a
a
a
a
a
a
a
a
a
a
a
a
a
a
a
a
a
a
a
a
a
a
a
a
a
a
a
a
a
a
a
a
a
a
a
a
a
a
a
a
a
a
a
a
a
j
j
j
j
K
K
j
j
a
j
K
K
K
K
K
K
j
"}
(7,1,1) = {"
a
a
a
a
a
a
a
a
a
a
a
a
a
a
a
a
a
a
a
a
a
a
a
a
a
a
a
a
a
a
a
a
a
a
a
a
a
a
a
a
a
a
a
a
a
a
a
a
a
a
a
a
a
a
a
a
a
a
a
a
a
a
a
a
a
a
a
a
a
a
a
a
a
a
a
a
a
a
a
a
a
a
j
j
K
K
K
K
K
K
j
j
j
K
K
K
K
K
K
j
"}
(8,1,1) = {"
a
a
a
a
a
a
a
a
a
a
a
a
a
a
a
a
a
a
a
a
a
a
a
a
a
a
a
a
a
a
a
a
a
a
a
a
a
a
a
a
a
a
a
a
a
a
a
a
a
a
a
a
a
a
a
a
a
a
a
a
a
a
a
a
a
a
a
a
a
a
a
a
a
a
a
a
a
a
a
a
a
j
j
K
K
K
K
K
K
K
K
K
K
K
K
K
K
K
K
j
"}
(9,1,1) = {"
a
a
a
a
a
a
a
a
a
a
a
a
a
a
a
a
a
a
a
a
a
a
a
a
a
a
a
a
a
a
a
a
a
a
a
a
a
a
a
a
a
a
a
a
a
a
a
a
a
a
a
a
a
a
a
a
a
a
a
a
a
a
j
j
j
j
j
j
j
j
a
a
a
a
a
a
a
a
a
a
j
j
K
K
K
K
K
K
K
K
K
K
K
K
K
K
K
K
K
j
"}
(10,1,1) = {"
a
a
a
a
a
a
a
a
a
a
a
a
a
a
a
a
a
a
a
a
a
a
a
a
a
a
a
a
a
a
a
a
a
a
a
a
a
a
a
a
a
a
a
a
a
a
a
a
a
a
a
a
a
a
a
a
a
a
a
a
a
j
j
s
s
s
s
s
s
j
j
j
a
a
a
a
a
a
a
j
j
K
K
K
K
K
K
K
K
K
K
K
K
K
K
K
K
K
K
j
"}
(11,1,1) = {"
a
a
a
a
a
a
a
a
a
a
a
a
a
a
a
a
a
a
a
a
a
a
a
a
a
a
a
a
a
a
a
a
a
a
a
a
a
a
a
a
a
a
a
a
a
a
a
a
a
a
a
a
a
a
a
a
a
a
a
a
a
j
s
s
s
s
s
s
s
s
s
j
j
j
j
j
a
j
j
j
K
K
K
K
K
K
K
K
K
K
K
K
K
K
K
K
K
K
K
j
"}
(12,1,1) = {"
a
a
a
a
a
a
a
a
a
a
a
a
a
a
a
a
a
a
a
a
a
a
a
a
a
a
a
a
a
a
a
a
a
a
a
a
a
a
a
a
a
a
a
a
a
a
a
a
a
a
a
a
a
a
a
a
a
a
a
a
j
j
s
s
s
s
s
s
s
s
s
s
s
s
s
j
j
j
s
s
s
K
K
K
K
K
K
K
K
K
K
K
K
K
K
K
K
K
K
j
"}
(13,1,1) = {"
a
a
a
a
a
a
a
a
a
a
a
a
a
a
a
a
a
a
a
a
a
a
a
a
a
a
a
a
a
a
a
a
a
a
a
a
a
a
a
a
a
a
a
a
a
a
a
a
a
a
a
a
a
a
a
a
a
a
a
a
j
s
s
s
s
s
s
s
s
s
s
s
s
s
s
s
s
s
s
s
s
s
K
K
K
K
K
K
K
K
K
K
K
K
K
K
K
K
K
j
"}
(14,1,1) = {"
a
a
a
a
a
a
a
a
a
a
a
a
a
a
a
a
a
a
a
a
a
a
a
a
a
a
a
a
a
a
a
a
a
a
a
a
a
a
a
a
a
a
a
a
a
a
a
a
a
a
a
a
a
a
a
a
a
a
a
a
j
s
s
s
s
s
s
s
s
s
s
s
s
s
s
s
s
s
s
s
s
s
s
K
K
K
K
K
K
K
K
K
K
K
K
K
K
j
j
j
"}
(15,1,1) = {"
a
a
a
a
a
a
a
a
a
a
a
a
a
a
a
a
a
a
a
a
a
a
a
a
a
a
a
a
a
a
a
a
a
a
a
a
a
a
a
a
a
a
a
a
a
a
a
a
a
a
a
a
a
a
a
a
a
a
a
a
j
s
s
s
s
s
s
s
s
s
s
s
s
s
s
s
s
s
s
s
s
U
U
l
K
K
K
K
K
K
K
K
K
K
K
K
K
K
j
a
"}
(16,1,1) = {"
a
a
a
a
a
a
a
a
a
a
a
a
a
a
a
a
a
a
a
a
a
a
a
a
a
a
a
a
a
a
a
a
a
a
a
a
a
a
a
a
a
a
a
a
a
a
a
a
a
a
a
a
a
a
a
a
a
a
a
a
j
s
s
s
s
s
s
s
s
s
s
s
s
s
s
s
s
s
s
U
U
l
l
l
K
K
K
K
K
K
K
K
K
K
K
K
K
K
j
a
"}
(17,1,1) = {"
a
a
a
a
a
a
a
a
a
a
a
a
a
a
a
a
a
a
a
a
a
a
a
a
a
a
a
a
a
a
a
a
a
a
a
a
a
a
a
a
a
a
a
a
a
a
a
a
a
a
a
a
a
a
a
a
a
a
a
a
j
s
s
s
s
s
s
s
s
s
s
s
s
s
s
s
s
s
s
U
U
l
l
l
l
l
l
K
K
K
K
K
K
K
K
K
K
K
j
a
"}
(18,1,1) = {"
a
a
a
a
a
a
a
a
a
a
a
a
a
a
a
a
a
a
a
a
a
a
a
a
a
a
a
a
a
a
a
a
a
a
a
a
a
a
a
a
a
a
a
a
a
a
a
a
a
a
a
a
a
a
a
a
a
a
a
a
j
s
s
s
s
s
s
s
s
s
s
s
s
s
s
s
s
s
U
U
l
l
l
l
l
l
l
K
K
K
K
K
K
K
K
K
K
K
j
a
"}
(19,1,1) = {"
a
a
a
a
a
a
a
a
a
a
a
a
a
a
a
a
a
a
a
a
a
a
a
a
a
a
a
a
a
a
a
a
a
a
a
a
a
a
a
a
a
a
a
a
a
a
a
a
a
a
a
a
a
a
a
a
a
a
a
j
j
s
s
s
s
s
s
s
s
s
s
s
s
s
s
s
s
U
U
U
l
l
l
l
l
l
l
K
K
K
K
K
K
K
K
K
K
K
j
a
"}
(20,1,1) = {"
a
a
a
a
a
a
a
a
a
a
a
a
a
a
a
a
a
a
a
a
a
a
a
a
a
a
a
a
a
a
a
a
a
a
a
a
a
a
a
a
a
a
a
a
a
a
a
a
a
a
a
a
a
a
a
a
a
a
a
j
s
s
s
s
s
s
s
s
s
s
s
s
s
s
s
s
s
U
U
l
l
Z
l
l
l
l
g
K
K
K
K
K
K
K
K
K
K
K
j
j
"}
(21,1,1) = {"
a
a
a
a
a
a
a
a
a
a
a
a
a
a
a
a
a
a
a
a
a
a
a
a
a
a
a
a
a
a
a
a
a
a
a
a
a
a
a
a
a
a
a
a
a
a
a
a
j
j
j
j
g
g
g
a
a
a
j
j
s
s
s
s
s
s
s
s
s
s
s
s
s
s
s
s
U
U
l
l
Z
Z
l
l
l
l
g
s
K
K
K
K
K
K
K
K
K
K
K
j
"}
(22,1,1) = {"
a
a
a
a
a
a
a
a
a
a
a
a
a
a
a
a
a
a
a
a
a
a
a
a
a
a
a
a
a
a
a
a
a
a
a
a
a
a
a
a
a
a
a
a
a
a
j
j
j
g
g
j
j
j
j
a
a
j
j
Z
Z
Z
Z
Z
Z
Z
Z
Z
Z
Z
Z
Z
Z
Z
Z
U
U
l
l
Z
Z
l
l
l
l
g
g
s
K
K
K
K
K
K
K
K
K
K
K
j
"}
(23,1,1) = {"
a
a
a
a
a
a
a
a
a
a
a
a
a
a
a
a
a
a
a
a
a
a
a
a
a
a
a
a
a
a
a
a
a
a
a
a
a
a
a
a
a
a
a
a
a
j
j
g
g
g
g
g
g
g
j
j
j
j
Z
Z
Z
Z
Z
Z
Z
Z
Z
Z
Z
Z
Z
Z
Z
Z
U
U
l
l
Z
Z
l
l
l
l
l
g
s
s
s
K
K
K
K
K
K
K
K
K
K
j
"}
(24,1,1) = {"
a
a
a
a
a
a
a
a
a
a
a
a
a
a
a
a
a
a
a
a
a
a
a
a
a
a
a
a
a
a
a
a
a
a
a
a
a
a
a
a
a
a
a
a
j
j
g
g
g
g
g
g
g
g
g
g
g
j
Z
Z
Z
Z
Z
Z
Z
Z
Z
Z
Z
Z
Z
U
U
U
U
l
l
Z
Z
l
l
l
l
l
l
g
s
s
s
K
K
K
K
K
K
K
K
K
K
j
"}
(25,1,1) = {"
a
a
a
a
a
a
a
a
a
a
a
a
a
a
a
a
a
a
a
a
a
a
a
a
a
a
a
a
a
a
a
a
a
a
a
a
a
a
a
a
a
a
a
j
j
g
g
g
g
g
g
g
g
g
g
g
g
j
Z
Z
Z
Z
Z
Z
Z
Z
Z
Z
Z
Z
U
U
l
l
l
l
l
Z
l
l
l
l
l
l
l
g
s
s
s
K
K
K
K
K
K
K
K
K
j
j
"}
(26,1,1) = {"
a
a
a
a
a
a
a
a
a
a
a
a
a
a
a
a
a
a
a
a
a
a
a
a
a
a
a
a
a
a
a
a
a
a
a
a
a
a
a
a
a
a
j
j
g
g
g
g
g
g
g
g
g
g
g
g
g
j
Z
Z
Z
Z
Z
Z
Z
Z
Z
Z
Z
Z
l
l
l
l
l
l
l
l
l
l
l
l
l
l
g
g
s
j
j
j
K
K
K
K
K
K
K
K
j
a
"}
(27,1,1) = {"
a
a
a
a
a
a
a
a
a
a
a
a
a
a
a
a
a
a
a
a
a
a
a
a
a
a
a
a
a
a
a
a
a
a
a
a
a
a
a
j
j
j
s
g
g
g
g
g
g
g
g
g
g
g
g
g
j
j
Z
Z
Z
Z
Z
Z
Z
U
Z
Z
l
l
l
l
l
l
l
l
l
l
l
l
l
l
l
l
g
s
j
j
a
j
j
K
K
K
K
K
K
K
j
a
"}
(28,1,1) = {"
a
a
a
a
a
a
a
a
a
a
a
a
a
a
a
a
a
a
a
a
a
a
a
a
a
a
a
a
a
a
a
a
a
a
a
a
a
a
j
j
s
s
s
s
g
g
g
g
g
g
g
g
g
g
g
j
j
Z
Z
Z
Z
Z
Z
Z
U
U
Z
l
l
l
l
l
l
l
l
l
l
l
l
l
l
l
l
g
s
j
j
a
a
a
j
j
K
K
K
K
K
K
j
a
"}
(29,1,1) = {"
a
a
a
a
a
a
a
a
a
a
a
a
a
a
a
a
a
a
a
a
a
a
a
a
a
a
a
a
a
a
a
a
a
a
a
a
a
a
j
s
s
s
s
s
s
g
g
g
g
g
g
g
g
j
j
j
Z
Z
Z
Z
Z
Z
Z
Z
U
Z
l
l
l
l
l
l
l
l
l
l
l
l
l
l
l
l
g
s
j
j
a
a
a
a
a
j
j
K
K
K
K
j
a
a
"}
(30,1,1) = {"
a
a
a
a
a
a
a
a
a
a
a
a
a
a
a
a
a
a
a
a
a
a
a
a
a
a
a
a
a
a
a
a
a
a
a
a
j
j
j
j
j
s
s
s
s
s
s
g
g
g
g
g
j
j
Z
Z
Z
Z
Z
Z
Z
Z
Z
U
Z
l
l
l
l
l
l
l
l
l
l
l
l
l
l
l
l
g
s
j
j
a
a
a
a
a
a
a
j
j
K
K
j
j
a
a
"}
(31,1,1) = {"
a
a
a
a
a
a
a
a
a
a
a
a
a
a
a
a
a
a
a
a
a
a
a
a
a
a
a
a
a
a
a
a
a
a
a
j
j
s
s
s
j
j
j
s
s
s
s
s
s
g
g
j
Z
Z
Z
Z
Z
Z
Z
Z
Z
Z
U
U
Z
l
l
l
l
l
l
l
l
l
l
l
l
l
l
l
g
s
s
j
a
a
a
a
a
a
a
a
a
j
j
j
j
a
a
a
"}
(32,1,1) = {"
a
a
a
a
a
a
a
a
a
a
a
a
a
a
a
a
a
a
a
a
a
a
a
a
a
a
a
a
a
a
a
a
a
j
j
s
s
s
s
s
s
s
j
j
j
s
s
s
s
j
j
j
Z
Z
Z
Z
Z
Z
Z
Z
Z
U
U
Z
l
l
l
l
l
l
l
l
l
l
l
l
l
l
g
g
s
s
j
j
a
a
a
a
a
a
a
a
a
a
a
a
a
a
a
a
"}
(33,1,1) = {"
a
a
a
a
a
a
a
a
a
a
a
a
a
a
a
a
a
a
a
a
a
a
a
a
a
a
a
a
a
a
a
a
j
j
s
s
s
s
s
s
s
s
s
s
j
j
j
j
j
j
g
g
g
g
g
g
Z
Z
Z
Z
Z
U
Z
Z
l
l
l
l
l
l
l
l
g
g
g
g
g
g
s
s
s
j
j
a
a
a
a
a
a
a
a
a
a
a
a
a
a
a
a
a
"}
(34,1,1) = {"
a
a
a
a
a
a
a
a
a
a
a
a
a
a
a
a
a
a
a
a
a
a
a
a
a
a
a
a
a
a
a
j
j
s
s
s
s
s
s
s
s
s
s
s
s
s
s
l
l
w
w
w
l
l
l
g
g
Z
Z
Z
U
U
Z
l
l
l
l
l
l
l
g
g
s
s
s
s
s
s
s
s
s
j
a
a
a
a
a
a
a
a
a
a
a
a
a
a
a
a
a
a
"}
(35,1,1) = {"
I
I
I
I
I
I
I
I
I
j
j
j
I
I
I
I
I
I
I
I
I
I
I
I
I
I
I
I
I
I
I
j
s
s
s
s
s
s
s
s
s
l
l
l
l
l
l
l
l
w
w
w
l
l
l
l
g
g
g
Z
U
Z
Z
l
l
l
l
l
l
l
g
s
s
s
s
s
s
s
s
s
s
j
j
j
j
a
a
a
a
a
a
a
a
a
a
a
a
a
a
a
"}
(36,1,1) = {"
I
I
I
I
I
I
I
I
j
j
X
j
j
j
I
I
I
I
I
I
I
I
I
I
I
I
I
I
I
I
I
j
s
s
s
s
s
s
s
s
l
l
l
l
l
l
l
l
l
w
w
w
l
l
l
l
l
l
g
g
U
Z
l
l
l
l
l
e
e
l
g
s
s
s
s
s
s
s
s
s
s
s
s
s
j
j
a
a
a
a
a
a
a
a
a
a
a
a
a
a
"}
(37,1,1) = {"
I
I
I
I
I
I
I
j
j
X
t
t
X
j
j
I
I
I
I
I
I
j
j
j
j
j
I
I
I
I
I
j
j
s
s
s
s
s
s
l
l
l
l
l
l
l
l
g
g
g
g
g
g
g
g
l
l
l
l
l
U
l
l
l
l
l
l
e
l
l
g
s
s
s
s
s
s
s
s
s
s
g
s
s
s
s
j
j
a
a
a
a
a
a
a
a
a
a
a
a
"}
(38,1,1) = {"
I
I
I
I
I
I
j
j
t
t
k
k
x
x
j
I
j
j
j
j
j
j
t
t
t
j
j
I
I
I
I
I
j
s
s
s
s
s
l
l
l
l
l
g
g
g
g
g
e
g
g
g
e
e
g
e
l
l
l
l
l
l
l
l
l
l
e
e
l
g
s
s
s
s
s
s
s
s
g
g
g
g
g
s
s
s
s
j
j
a
a
a
a
a
a
a
a
a
a
a
"}
(39,1,1) = {"
I
I
I
I
I
j
j
t
t
k
k
v
G
x
j
j
j
t
t
t
t
t
t
G
t
X
t
j
I
I
I
I
j
s
s
s
s
l
l
l
l
l
g
g
e
e
e
e
e
g
g
g
e
e
e
g
l
l
l
l
l
l
l
l
l
e
e
l
l
g
s
s
s
s
s
s
s
g
g
g
g
g
e
g
s
s
s
s
s
j
a
a
a
a
a
a
a
a
a
a
"}
(40,1,1) = {"
I
I
I
I
j
j
x
t
k
G
G
G
G
G
G
G
G
G
G
G
G
G
G
G
G
G
x
j
j
I
I
I
j
s
s
s
l
l
l
l
l
l
g
e
e
e
e
e
e
g
g
g
e
e
e
g
g
l
l
l
l
l
l
l
l
e
l
l
g
s
s
s
s
s
s
s
g
g
g
g
g
g
e
g
g
s
s
s
s
j
j
a
a
a
a
a
a
a
a
a
"}
(41,1,1) = {"
I
I
I
I
j
x
x
G
G
G
b
G
b
G
G
G
G
G
G
G
b
G
b
G
G
G
x
x
j
I
I
I
j
s
s
l
l
l
l
l
l
g
g
e
e
e
e
g
g
g
g
g
g
g
e
e
g
g
g
P
l
l
l
l
l
l
l
g
s
s
s
s
s
s
s
s
g
g
g
g
e
e
g
g
g
s
s
s
s
s
j
a
a
a
a
a
a
a
a
a
"}
(42,1,1) = {"
I
I
I
j
j
x
x
G
G
b
b
b
b
b
G
G
G
G
G
b
b
b
b
b
G
G
G
x
j
j
I
I
j
s
s
l
l
l
l
l
g
g
e
e
e
g
g
g
g
g
g
g
g
g
g
g
e
e
e
g
g
l
l
l
l
g
g
s
s
s
s
s
s
s
s
g
g
g
g
g
e
e
g
g
g
s
s
s
s
s
s
j
a
a
a
a
a
a
a
a
"}
(43,1,1) = {"
I
I
j
j
x
x
x
G
b
b
T
n
u
b
b
G
G
G
b
b
T
n
u
b
b
G
G
x
x
e
j
j
j
s
s
l
l
l
l
l
g
e
e
e
g
g
g
g
e
e
i
e
e
g
g
g
g
e
e
e
g
g
l
l
g
s
s
s
s
s
s
s
s
s
s
g
g
g
g
g
e
g
g
g
e
g
s
s
s
s
s
j
a
a
a
a
a
a
a
a
"}
(44,1,1) = {"
b
b
b
x
x
x
x
G
G
b
E
G
u
b
G
G
G
G
G
b
E
G
u
b
G
G
G
G
Y
e
e
e
j
s
l
l
l
l
l
g
g
e
e
g
g
g
e
e
e
j
j
j
e
e
e
g
g
g
g
g
g
g
l
l
l
g
s
s
s
s
s
s
s
s
s
g
g
g
g
e
g
s
g
g
e
g
s
s
s
s
s
s
j
a
a
a
a
a
a
a
"}
(45,1,1) = {"
M
M
b
b
x
x
x
G
b
b
o
G
G
b
b
G
Y
G
b
b
o
G
G
b
b
G
G
e
g
e
e
e
j
s
l
l
l
l
g
g
e
e
g
g
g
e
e
j
j
j
B
j
j
j
e
e
g
g
g
g
g
g
g
l
l
l
g
s
s
s
s
s
s
s
g
g
g
g
g
e
g
s
g
g
e
g
s
s
s
s
s
s
j
j
a
a
a
a
a
a
"}
(46,1,1) = {"
x
x
c
b
b
x
x
G
G
b
b
H
b
b
G
G
g
g
e
b
b
H
b
b
G
G
G
e
e
g
e
e
j
s
l
l
l
g
g
e
e
e
g
g
e
i
j
j
x
x
x
x
x
j
j
e
e
g
g
g
g
g
g
g
l
l
l
g
s
s
s
s
s
s
g
g
g
g
g
e
g
s
g
g
e
g
s
s
s
s
s
s
s
j
a
a
a
a
a
a
"}
(47,1,1) = {"
x
x
x
x
b
x
x
G
G
G
b
G
b
e
e
g
g
e
e
e
b
G
b
G
G
G
G
G
e
e
e
j
e
e
l
l
l
g
e
e
e
g
g
g
e
j
j
p
x
x
G
x
x
p
j
j
e
e
e
e
e
e
g
g
l
l
l
P
s
s
s
s
s
g
g
g
g
g
g
g
s
s
s
g
g
P
s
s
s
s
s
s
s
j
j
a
a
a
a
a
"}
(48,1,1) = {"
m
m
x
x
b
b
x
G
G
G
G
G
e
e
e
e
e
e
e
e
e
G
G
G
G
G
G
G
G
e
e
j
e
e
l
l
l
g
e
e
e
g
g
e
e
j
x
x
x
G
G
G
x
x
x
j
j
j
j
j
j
e
g
g
W
l
l
l
g
g
g
g
g
g
g
g
g
g
s
s
s
s
s
g
g
g
s
s
s
s
s
s
s
s
j
a
a
a
a
a
"}
(49,1,1) = {"
V
q
R
x
x
d
G
G
G
G
G
G
e
e
e
l
l
e
e
g
e
G
G
G
G
G
G
G
e
e
e
e
e
g
A
A
A
g
g
g
g
g
g
e
j
j
x
x
G
G
G
G
G
x
x
x
x
x
x
x
y
e
e
g
g
w
w
w
g
g
g
g
g
g
g
g
g
g
s
s
s
s
s
g
g
g
s
s
s
s
s
s
s
s
j
j
a
a
a
a
"}
(50,1,1) = {"
N
C
L
x
x
H
G
G
G
G
G
G
e
g
e
l
l
l
e
g
G
G
G
G
G
G
G
G
e
e
g
e
e
g
A
A
A
g
g
g
g
g
g
e
j
B
x
G
G
G
h
G
G
G
x
b
G
G
G
G
y
e
e
g
g
w
w
w
g
g
g
g
g
g
g
g
P
g
s
s
s
s
s
g
g
g
s
s
s
s
s
s
s
s
s
j
a
a
a
a
"}
(51,1,1) = {"
D
Q
F
G
G
d
G
G
G
G
G
G
g
e
e
e
l
l
e
g
G
G
G
G
G
G
G
e
e
g
g
e
g
g
A
A
A
g
g
g
g
g
g
e
j
j
x
x
G
G
G
G
G
x
x
x
x
x
x
x
y
e
e
g
g
w
w
w
g
g
g
g
g
g
g
g
e
g
s
s
s
s
g
g
g
g
s
s
s
s
s
s
s
s
s
j
j
a
a
a
"}
(52,1,1) = {"
S
S
G
G
b
b
G
G
G
G
G
G
g
g
e
e
l
e
e
g
G
G
G
G
G
G
G
e
e
g
j
s
s
s
l
l
l
l
l
P
g
g
g
e
e
j
x
x
x
G
G
G
x
x
x
j
j
j
j
j
j
e
g
g
W
l
l
l
s
g
g
g
g
g
g
e
g
g
s
s
s
s
g
g
g
e
s
s
s
s
s
s
s
s
s
s
j
a
a
a
"}
(53,1,1) = {"
G
G
G
G
b
G
G
G
Y
G
b
G
b
e
e
e
e
e
e
e
b
G
b
G
G
G
G
e
e
e
j
s
s
s
l
l
l
l
l
l
g
g
g
g
e
j
j
p
x
x
G
x
x
p
j
j
e
e
e
e
e
e
g
g
l
l
l
s
s
g
g
g
g
g
e
e
g
s
s
s
s
s
g
g
g
e
s
s
s
s
s
s
s
s
s
s
j
j
a
a
"}
(54,1,1) = {"
G
G
Y
b
b
j
G
G
G
b
b
H
b
b
e
e
g
g
e
b
b
H
b
b
G
G
Y
e
e
e
j
s
s
s
l
l
l
l
l
l
g
e
g
g
e
e
j
j
x
x
x
x
x
j
j
e
e
g
g
g
g
g
g
g
l
l
l
s
s
g
e
g
e
e
e
g
g
s
s
s
s
s
g
g
g
e
s
s
s
s
s
s
s
s
s
s
s
j
a
a
"}
(55,1,1) = {"
u
u
b
b
I
j
G
G
b
b
o
G
G
b
b
g
g
g
b
b
o
G
G
b
b
G
G
e
e
e
j
j
s
s
s
l
l
l
l
l
g
e
g
g
g
e
e
j
j
j
B
j
j
j
e
i
g
g
g
g
g
g
g
l
l
l
s
s
s
s
g
g
g
g
g
g
s
s
s
s
s
s
g
g
e
g
s
s
s
s
s
s
s
s
s
s
s
j
a
a
"}
(56,1,1) = {"
b
b
b
I
I
j
G
G
G
b
E
G
u
b
G
G
G
G
G
b
E
G
u
b
G
G
G
x
e
j
I
j
j
s
s
s
l
l
l
l
g
g
e
g
g
g
e
e
e
j
j
j
e
e
e
g
g
g
g
g
g
g
l
l
l
l
s
s
s
s
s
s
s
s
s
s
s
s
s
s
s
s
g
g
e
g
s
s
s
s
s
s
s
s
s
s
s
j
a
a
"}
(57,1,1) = {"
I
I
I
I
j
j
x
G
b
b
T
n
u
b
b
G
G
G
b
b
T
n
u
b
b
G
x
x
j
I
I
I
j
s
s
s
s
l
l
l
l
g
e
e
g
g
g
g
e
e
e
e
e
g
g
g
g
e
e
e
g
g
l
l
l
s
s
s
s
s
s
s
s
s
s
s
s
s
s
s
s
s
g
g
e
g
s
s
s
s
s
s
s
s
s
s
s
j
a
a
"}
(58,1,1) = {"
I
I
I
I
j
x
x
G
G
b
b
b
b
b
G
G
Y
G
G
b
b
b
b
b
x
x
x
j
I
I
I
I
j
s
s
s
s
l
l
l
l
g
e
e
e
g
g
g
g
g
P
g
g
g
g
g
e
e
e
g
g
l
l
l
s
s
s
s
s
s
s
s
s
s
s
s
s
s
s
s
s
s
g
g
e
g
s
s
s
s
s
s
g
g
s
s
s
j
a
a
"}
(59,1,1) = {"
I
I
I
I
j
j
x
x
G
G
b
G
b
G
G
G
G
G
G
G
b
G
b
x
x
j
j
I
I
I
I
I
j
s
s
s
s
l
l
l
l
g
g
e
e
e
e
g
g
g
g
g
g
g
e
e
e
e
e
g
e
l
l
s
s
s
s
s
s
s
s
s
s
s
s
s
s
s
s
s
s
g
g
g
g
s
s
s
s
s
s
g
P
g
s
s
s
j
a
a
"}
(60,1,1) = {"
I
I
I
I
I
j
j
x
x
G
x
x
x
x
x
j
x
x
G
G
G
x
x
x
j
I
I
I
I
I
I
I
j
s
s
s
s
s
l
l
l
e
g
e
e
e
e
e
e
g
g
g
e
e
e
e
e
e
g
g
l
l
l
s
s
s
s
s
s
s
s
s
s
s
s
s
s
s
s
s
s
g
g
e
g
s
s
s
s
s
g
g
g
g
s
s
s
j
a
a
"}
(61,1,1) = {"
I
I
I
I
I
I
j
j
x
x
x
j
j
j
j
j
j
x
x
x
x
x
j
j
j
I
I
I
I
I
I
I
j
s
s
s
s
l
l
l
l
e
g
e
e
e
e
e
e
g
g
g
e
e
e
e
g
g
g
i
l
l
s
s
s
s
s
s
s
s
s
s
s
s
s
s
s
s
s
s
s
g
g
g
g
s
s
s
s
g
g
g
g
s
s
s
s
j
a
a
"}
(62,1,1) = {"
I
I
I
I
I
I
I
j
j
j
j
j
I
I
I
I
j
j
j
j
j
j
j
I
I
I
I
I
I
I
I
I
j
s
s
s
s
l
l
l
l
g
g
e
e
e
e
e
e
g
g
g
e
e
e
g
g
l
l
l
l
l
s
s
s
s
s
s
s
s
s
s
s
s
s
s
s
s
s
s
s
g
g
g
s
s
s
s
s
g
g
g
g
s
s
s
s
j
a
a
"}
(63,1,1) = {"
I
I
I
I
I
I
I
I
I
I
I
I
I
I
I
I
I
I
I
I
I
I
I
I
I
I
I
I
I
I
I
I
j
s
s
s
s
l
l
l
l
g
e
e
e
e
g
g
g
g
g
g
e
e
g
g
l
l
l
l
l
s
s
s
s
s
s
s
s
s
s
s
s
s
s
s
s
s
s
s
s
g
e
g
s
s
s
s
g
g
g
g
s
s
s
s
s
j
a
a
"}
(64,1,1) = {"
I
I
I
I
I
I
I
I
I
I
I
I
I
I
I
I
I
I
I
I
I
I
I
I
I
I
I
I
I
I
I
I
j
s
s
s
s
l
l
l
e
g
e
e
e
g
g
l
l
w
w
w
l
g
g
l
l
l
s
s
s
s
s
s
s
s
s
s
s
s
s
s
s
s
s
s
s
s
s
s
g
g
e
g
g
s
s
g
g
g
g
g
s
s
s
s
j
j
a
a
"}
(65,1,1) = {"
I
I
I
I
I
I
I
I
I
I
I
I
I
I
I
I
I
I
I
I
I
I
I
I
I
I
I
I
I
I
I
I
j
s
s
s
s
l
l
l
l
g
e
e
g
g
l
l
l
w
w
w
l
l
l
l
l
l
s
s
s
s
s
s
s
s
s
s
s
s
s
s
s
s
s
s
s
s
s
s
g
g
g
g
g
g
g
g
g
g
g
s
s
s
s
s
j
a
a
a
"}
(66,1,1) = {"
I
I
I
I
I
I
I
I
I
I
I
I
I
I
I
I
I
I
I
I
I
I
I
I
I
I
I
I
I
I
I
I
j
j
j
s
s
s
l
l
l
g
g
g
g
l
l
l
l
w
w
w
l
l
l
l
l
s
s
s
s
s
s
s
s
s
s
s
s
s
s
s
s
s
s
s
s
s
s
s
g
g
g
g
g
P
g
g
g
g
g
s
s
s
s
s
j
a
a
a
"}
(67,1,1) = {"
I
I
I
I
I
I
I
I
I
I
I
I
I
I
I
I
I
I
I
I
I
I
I
I
I
I
I
I
I
I
I
I
j
a
j
j
s
s
l
l
l
l
l
l
l
l
l
l
l
g
g
g
s
s
s
s
s
s
s
s
s
s
s
s
s
s
s
s
s
s
s
s
s
s
s
s
s
s
s
s
g
g
g
g
g
g
g
g
g
g
s
s
s
s
s
s
j
a
a
a
"}
(68,1,1) = {"
I
I
I
I
I
I
I
I
I
I
I
I
I
I
I
I
I
I
I
I
I
I
I
I
I
I
I
I
I
I
I
I
j
a
a
j
j
s
l
l
l
l
l
l
l
l
l
j
j
j
g
g
s
s
s
s
s
s
s
s
s
s
s
s
s
s
s
s
s
s
s
s
s
s
s
s
s
s
s
s
e
g
g
g
s
g
g
g
s
s
s
s
s
s
s
s
j
a
a
a
"}
(69,1,1) = {"
I
I
I
I
I
I
I
I
I
I
I
I
I
I
I
I
I
I
I
I
I
I
I
I
I
I
I
I
I
I
I
I
j
a
a
a
j
j
j
l
l
l
l
l
l
l
j
j
a
j
j
j
j
s
s
s
s
s
s
s
s
s
s
s
s
s
s
s
s
s
s
s
s
s
s
s
s
s
s
s
g
g
g
g
s
s
s
s
s
s
s
s
s
s
s
s
j
a
a
a
"}
(70,1,1) = {"
I
I
I
I
I
I
I
I
I
I
I
I
I
I
I
I
I
I
I
I
I
I
I
I
I
I
I
I
I
I
I
j
j
a
a
a
a
a
j
j
s
j
j
j
j
j
j
a
a
a
a
a
j
j
j
j
s
s
s
s
s
s
s
s
s
s
s
s
s
s
s
s
s
s
s
s
s
s
s
g
g
g
e
g
s
s
s
s
s
s
s
s
s
s
s
s
j
a
a
a
"}
(71,1,1) = {"
I
I
I
I
I
I
I
I
I
I
I
I
I
I
I
I
I
I
I
I
I
I
I
I
I
I
I
I
I
I
I
j
a
a
a
a
a
a
a
j
j
j
a
a
a
a
a
a
a
a
a
a
a
a
a
j
j
j
s
s
s
s
s
s
s
s
s
s
s
s
s
s
s
s
s
s
s
s
s
g
g
g
g
e
s
s
s
s
s
s
s
s
s
s
s
s
j
j
a
a
"}
(72,1,1) = {"
a
a
a
a
a
a
a
a
a
a
a
a
a
a
a
a
a
a
a
a
a
a
a
a
a
a
a
a
a
a
a
a
a
a
a
a
a
a
a
a
a
a
a
a
a
a
a
a
a
a
a
a
a
a
a
a
a
j
j
j
s
s
s
s
s
s
s
s
s
s
s
s
s
s
s
s
s
s
s
g
e
g
g
g
s
s
s
s
s
s
s
s
s
s
s
s
s
j
j
a
"}
(73,1,1) = {"
a
a
a
a
a
a
a
a
a
a
a
a
a
a
a
a
a
a
a
a
a
a
a
a
a
a
a
a
a
a
a
a
a
a
a
a
a
a
a
a
a
a
a
a
a
a
a
a
a
a
a
a
a
a
a
a
a
a
a
j
j
s
s
s
s
s
s
s
s
s
s
s
s
s
s
s
s
s
s
g
e
e
g
g
s
s
s
s
s
s
s
s
s
s
s
s
s
s
j
j
"}
(74,1,1) = {"
a
a
a
a
a
a
a
a
a
a
a
a
a
a
a
a
a
a
a
a
a
a
a
a
a
a
a
a
a
a
a
a
a
a
a
a
a
a
a
a
a
a
a
a
a
a
a
a
a
a
a
a
a
a
a
a
a
a
a
a
j
j
s
s
s
s
s
s
s
s
s
s
s
s
s
s
s
s
s
g
g
P
s
s
s
s
s
s
s
s
s
s
s
s
s
s
e
e
s
j
"}
(75,1,1) = {"
a
a
a
a
a
a
a
a
a
a
a
a
a
a
a
a
a
a
a
a
a
a
a
a
a
a
a
a
a
a
a
a
a
a
a
a
a
a
a
a
a
a
a
a
a
a
a
a
a
a
a
a
a
a
a
a
a
a
a
a
a
j
j
s
s
s
s
s
s
s
s
s
s
s
s
s
s
s
s
g
g
s
s
s
s
s
s
s
s
s
s
s
g
g
g
g
e
e
s
j
"}
(76,1,1) = {"
a
a
a
a
a
a
a
a
a
a
a
a
a
a
a
a
a
a
a
a
a
a
a
a
a
a
a
a
a
a
a
a
a
a
a
a
a
a
a
a
a
a
a
a
a
a
a
a
a
a
a
a
a
a
a
a
a
a
a
a
a
a
j
s
s
s
s
s
s
s
s
s
s
s
s
s
s
s
s
g
g
s
s
s
s
s
s
s
s
s
g
g
g
g
g
g
e
e
s
j
"}
(77,1,1) = {"
a
a
a
a
a
a
a
a
a
a
a
a
a
a
a
a
a
a
a
a
a
a
a
a
a
a
a
a
a
a
a
a
a
a
a
a
a
a
a
a
a
a
a
a
a
a
a
a
a
a
a
a
a
a
a
a
a
a
a
a
a
a
j
j
s
s
s
s
s
s
s
s
s
s
s
s
s
s
g
e
g
s
s
s
s
s
s
s
s
s
g
g
g
g
g
g
g
e
s
j
"}
(78,1,1) = {"
a
a
a
a
a
a
a
a
a
a
a
a
a
a
a
a
a
a
a
a
a
a
a
a
a
a
a
a
a
a
a
a
a
a
a
a
a
a
a
a
a
a
a
a
a
a
a
a
a
a
a
a
a
a
a
a
a
a
a
a
a
a
a
j
s
s
s
s
s
s
s
s
s
s
s
s
s
s
g
e
g
g
s
s
s
s
s
s
s
g
e
e
e
e
g
g
g
e
s
j
"}
(79,1,1) = {"
a
a
a
a
a
a
a
a
a
a
a
a
a
a
a
a
a
a
a
a
a
a
a
a
a
a
a
a
a
a
a
a
a
a
a
a
a
a
a
a
a
a
a
a
a
a
a
a
a
a
a
a
a
a
a
a
a
a
a
a
a
a
a
j
j
s
s
s
s
s
s
s
s
s
j
j
j
s
s
g
g
g
s
s
s
s
s
s
s
g
e
s
s
e
g
g
g
i
e
j
"}
(80,1,1) = {"
a
a
a
a
a
a
a
a
a
a
a
a
a
a
a
a
a
a
a
a
a
a
a
a
a
a
a
a
a
a
a
a
a
a
a
a
a
a
a
a
a
a
a
a
a
a
a
a
a
a
a
a
a
a
a
a
a
a
a
a
a
a
a
a
j
s
s
s
s
s
s
s
s
s
j
a
j
j
s
s
g
g
g
s
s
s
s
g
g
e
s
s
s
e
g
g
g
e
e
j
"}
(81,1,1) = {"
a
a
a
a
a
a
a
a
a
a
a
a
a
a
a
a
a
a
a
a
a
a
a
a
a
a
a
a
a
a
a
a
a
a
a
a
a
a
a
a
a
a
a
a
a
a
a
a
a
a
a
a
a
a
a
a
a
a
a
a
a
a
a
a
j
s
s
s
s
s
s
s
s
s
j
a
a
j
s
s
s
g
g
g
e
g
g
g
g
s
s
s
s
e
g
g
g
g
e
j
"}
(82,1,1) = {"
a
a
a
a
a
a
a
a
a
a
a
a
a
a
a
a
a
a
a
a
a
a
a
a
a
a
a
a
a
a
a
a
a
a
a
a
a
a
a
a
a
a
a
a
a
a
a
a
a
a
a
a
a
a
a
a
a
a
a
a
a
a
a
a
j
j
j
s
s
s
s
s
s
s
j
a
a
j
j
s
s
g
g
g
g
g
g
g
g
s
s
s
s
e
g
g
g
g
e
j
"}
(83,1,1) = {"
a
a
a
a
a
a
a
a
a
a
a
a
a
a
a
a
a
a
a
a
a
a
a
a
a
a
a
a
a
a
a
a
a
a
a
a
a
a
a
a
a
a
a
a
a
a
a
a
a
a
a
a
a
a
a
a
a
a
a
a
a
a
a
a
a
a
j
j
s
s
s
s
s
j
j
a
a
a
j
j
s
s
g
g
g
g
g
P
s
s
s
s
s
e
e
g
g
g
e
j
"}
(84,1,1) = {"
a
a
a
a
a
a
a
a
a
a
a
a
a
a
a
a
a
a
a
a
a
a
a
a
a
a
a
a
a
a
a
a
a
a
a
a
a
a
a
a
a
a
a
a
a
a
a
a
a
a
a
a
a
a
a
a
a
a
a
a
a
a
a
a
a
a
a
j
j
j
j
j
j
j
a
a
a
a
a
j
j
s
s
s
s
s
s
s
s
s
s
s
s
s
e
g
g
g
e
j
"}
(85,1,1) = {"
a
a
a
a
a
a
a
a
a
a
a
a
a
a
a
a
a
a
a
a
a
a
a
a
a
a
a
a
a
a
a
a
a
a
a
a
a
a
a
a
a
a
a
a
a
a
a
a
a
a
a
a
a
a
a
a
a
a
a
a
a
a
a
a
a
a
a
a
a
a
a
a
a
a
a
a
a
a
a
a
j
j
s
s
s
s
s
s
s
s
s
s
s
s
e
g
g
g
e
e
"}
(86,1,1) = {"
a
a
a
a
a
a
a
a
a
a
a
a
a
a
a
a
a
a
a
a
a
a
a
a
a
a
a
a
a
a
a
a
a
a
a
a
a
a
a
a
a
a
a
a
a
a
a
a
a
a
a
a
a
a
a
a
a
a
a
a
a
a
a
a
a
a
a
a
a
a
a
a
a
a
a
a
a
a
a
a
a
j
j
s
s
s
s
s
s
s
s
s
s
s
e
e
g
g
g
e
"}
(87,1,1) = {"
a
a
a
a
a
a
a
a
a
a
a
a
a
a
a
a
a
a
a
a
a
a
a
a
a
a
a
a
a
a
a
a
a
a
a
a
a
a
a
a
a
a
a
a
a
a
a
a
a
a
a
a
a
a
a
a
a
a
a
a
a
a
a
a
a
a
a
a
a
a
a
a
a
a
a
a
a
a
a
a
a
a
j
j
s
s
s
s
s
s
s
s
s
s
s
e
g
g
g
e
"}
(88,1,1) = {"
a
a
a
a
a
a
a
a
a
a
a
a
a
a
a
a
a
a
a
a
a
a
a
a
a
a
a
a
a
a
a
a
a
a
a
a
a
a
a
a
a
a
a
a
a
a
a
a
a
a
a
a
a
a
a
a
a
a
a
a
a
a
a
a
a
a
a
a
a
a
a
a
a
a
a
a
a
a
a
a
a
a
a
a
j
j
s
s
s
s
s
s
s
s
s
e
e
g
g
g
"}
(89,1,1) = {"
a
a
a
a
a
a
a
a
a
a
a
a
a
a
a
a
a
a
a
a
a
a
a
a
a
a
a
a
a
a
a
a
a
a
a
a
a
a
a
a
a
a
a
a
a
a
a
a
a
a
a
a
a
a
a
a
a
a
a
a
a
a
a
a
a
a
a
a
a
a
a
a
a
a
a
a
a
a
a
a
a
a
a
a
a
a
j
j
s
s
s
s
s
s
s
s
e
g
g
g
"}
(90,1,1) = {"
a
a
a
a
a
a
a
a
a
a
a
a
a
a
a
a
a
a
a
a
a
a
a
a
a
a
a
a
a
a
a
a
a
a
a
a
a
a
a
a
a
a
a
a
a
a
a
a
a
a
a
a
a
a
a
a
a
a
a
a
a
a
a
a
a
a
a
a
a
a
a
a
a
a
a
a
a
a
a
a
a
a
a
a
a
a
a
j
s
s
s
s
s
s
s
s
e
g
g
f
"}
(91,1,1) = {"
a
a
a
a
a
a
a
a
a
a
a
a
a
a
a
a
a
a
a
a
a
a
a
a
a
a
a
a
a
a
a
a
a
a
a
a
a
a
a
a
a
a
a
a
a
a
a
a
a
a
a
a
a
a
a
a
a
a
a
a
a
a
a
a
a
a
a
a
a
a
a
a
a
a
a
a
a
a
a
a
a
a
a
a
a
a
a
a
j
s
s
s
s
s
s
s
e
e
g
g
"}
(92,1,1) = {"
a
a
a
a
a
a
a
a
a
a
a
a
a
a
a
a
a
a
a
a
a
a
a
a
a
a
a
a
a
a
a
a
a
a
a
a
a
a
a
a
a
a
a
a
a
a
a
a
a
a
a
a
a
a
a
a
a
a
a
a
a
a
a
a
a
a
a
a
a
a
a
a
a
a
a
a
a
a
a
a
a
a
a
a
a
a
a
a
j
j
s
s
s
s
s
s
s
e
g
g
"}
(93,1,1) = {"
a
a
a
a
a
a
a
a
a
a
a
a
a
a
a
a
a
a
a
a
a
a
a
a
a
a
a
a
a
a
a
a
a
a
a
a
a
a
a
a
a
a
a
a
a
a
a
a
a
a
a
a
a
a
a
a
a
a
a
a
a
a
a
a
a
a
a
a
a
a
a
a
a
a
a
a
a
a
a
a
a
a
a
a
a
a
a
a
a
j
j
s
s
s
s
s
s
e
e
g
"}
(94,1,1) = {"
a
a
a
a
a
a
a
a
a
a
a
a
a
a
a
a
a
a
a
a
a
a
a
a
a
a
a
a
a
a
a
a
a
a
a
a
a
a
a
a
a
a
a
a
a
a
a
a
a
a
a
a
a
a
a
a
a
a
a
a
a
a
a
a
a
a
a
a
a
a
a
a
a
a
a
a
a
a
a
a
a
a
a
a
a
a
a
a
a
a
j
s
s
s
s
s
s
e
e
e
"}
(95,1,1) = {"
a
a
a
a
a
a
a
a
a
a
a
a
a
a
a
a
a
a
a
a
a
a
a
a
a
a
a
a
a
a
a
a
a
a
a
a
a
a
a
a
a
a
a
a
a
a
a
a
a
a
a
a
a
a
a
a
a
a
a
a
a
a
a
a
a
a
a
a
a
a
a
a
a
a
a
a
a
a
a
a
a
a
a
a
a
a
a
a
a
a
a
j
s
s
s
s
s
s
e
e
"}
(96,1,1) = {"
a
a
a
a
a
a
a
a
a
a
a
a
a
a
a
a
a
a
a
a
a
a
a
a
a
a
a
a
a
a
a
a
a
a
a
a
a
a
a
a
a
a
a
a
a
a
a
a
a
a
a
a
a
a
a
a
a
a
a
a
a
a
a
a
a
a
a
a
a
a
a
a
a
a
a
a
a
a
a
a
a
a
a
a
a
a
a
a
a
a
a
j
j
s
s
s
s
s
s
s
"}
(97,1,1) = {"
a
a
a
a
a
a
a
a
a
a
a
a
a
a
a
a
a
a
a
a
a
a
a
a
a
a
a
a
a
a
a
a
a
a
a
a
a
a
a
a
a
a
a
a
a
a
a
a
a
a
a
a
a
a
a
a
a
a
a
a
a
a
a
a
a
a
a
a
a
a
a
a
a
a
a
a
a
a
a
a
a
a
a
a
a
a
a
a
a
a
a
a
j
j
j
j
j
j
j
s
"}
(98,1,1) = {"
a
a
a
a
a
a
a
a
a
a
a
a
a
a
a
a
a
a
a
a
a
a
a
a
a
a
a
a
a
a
a
a
a
a
a
a
a
a
a
a
a
a
a
a
a
a
a
a
a
a
a
a
a
a
a
a
a
a
a
a
a
a
a
a
a
a
a
a
a
a
a
a
a
a
a
a
a
a
a
a
a
a
a
a
a
a
a
a
a
a
a
a
a
a
a
a
a
a
j
j
"}
(99,1,1) = {"
a
a
a
a
a
a
a
a
a
a
a
a
a
a
a
a
a
a
a
a
a
a
a
a
a
a
a
a
a
a
a
a
a
a
a
a
a
a
a
a
a
a
a
a
a
a
a
a
a
a
a
a
a
a
a
a
a
a
a
a
a
a
a
a
a
a
a
a
a
a
a
a
a
a
a
a
a
a
a
a
a
a
a
a
a
a
a
a
a
a
a
a
a
a
a
a
a
a
a
j
"}
(100,1,1) = {"
a
a
a
a
a
a
a
a
a
a
a
a
a
a
a
a
a
a
a
a
a
a
a
a
a
a
a
a
a
a
a
a
a
a
a
a
a
a
a
a
a
a
a
a
a
a
a
a
a
a
a
a
a
a
a
a
a
a
a
a
a
a
a
a
a
a
a
a
a
a
a
a
a
a
a
a
a
a
a
a
a
a
a
a
a
a
a
a
a
a
a
a
a
a
a
a
a
a
a
a
"}
